!!ATOK_TANGO_TEXT_HEADER_1
!! 18禁ゲーム声優辞書 for ATOK2005
!! 2007年05月12日版　No.1：基本辞書

!! ■あ行
あいかわなな	逢川奈々	固有人名
あいらふみ	愛羅歩未	固有人名
あおいかずき	あおい和樹	固有人名
あおいるな	青泉瑠奈	固有人名
あおきそら	青木そら	固有人名
あおきみーな	青木みーな	固有人名
あおのれいん	青野レイン	固有人名
あおばかえで	青葉楓	固有人名
あおばりんご	青葉りんご	固有人名
あおやまとうこ	青山桐子	固有人名
あかいとまと	赤井とまと	固有人名
あかいりんご	赤威林檎	固有人名
あかがわまき	あかがわまき	固有人名
あかぎみえ	赤城美絵	固有人名
あかしあんな	赤白杏奈	固有人名
あかしろあんな	赤白杏奈	固有人名	「あかしあんな」の誤り	しない
あきづきまい	秋月まい	固有人名
あきづきみちる	秋月みちる	固有人名
あぐみおと	安玖深音	固有人名
あさきそよ	朝咲そよ	固有人名
あさきゆめみ	朝木ユメミ	固有人名
あさくらすずね	朝倉鈴音	固有人名
あさだようこ	浅田葉子	固有人名
あさといずみ	浅都泉	固有人名
あさみゆずる	浅海譲	固有人名
あずましん	東慎	固有人名
あそうなの	亜蒼ナノ	固有人名
あそうみゅう	麻生みゅう	固有人名
あだちしのぶ	安達忍	固有人名
あまくにさかな	雨邦さかな	固有人名
あまねりんご	天音凛	固有人名
あまみやまさたけ	雨宮正武	固有人名
あやかわりの	綾川りの	固有人名
あやせゆう	彩世ゆう	固有人名
あやのこうじるか	綾小路流花	固有人名
あゆかわひなた	鮎川ひなた	固有人名
あらかわみなこ	荒川美奈子	固有人名
ありぞのつかさ	有園司	固有人名
いいだくう	飯田空	固有人名
いいだそら	飯田空	固有人名	「いいだくう」の誤り	しない
いしももこ	石桃子	固有人名
いしづかなつみ	石塚奈津美	固有人名
いずみときひこ	和泉時彦	固有人名
いちじょうかずや	一条和矢	固有人名
いちのみやさくら	一宮桜	固有人名
いっしきひかる	一色ヒカル	固有人名
いのうえきょうこ	井上京子	固有人名
いわいずみまい	岩泉まい	固有人名
いわおぜんしゅう	巌蝉秋	固有人名
いわきゆな	岩城由奈	固有人名
いわもとりか	岩本里夏	固有人名
うえあおい	うえあおい	固有人名
うえいみゅん	上井みゅん	固有人名
うえきとおる	植木亨	固有人名
うえとりゅう	上戸琉	固有人名
うえべっぷひとし	上別府仁資	固有人名	「びふひとし」の誤り	しない
うえもとのぞみ	上本のぞみ	固有人名
うさみももか	宇佐美桃香	固有人名
うだかなる	羽高なる	固有人名
うたのまい	唄野舞	固有人名
うちのはじめ	内野一	固有人名
うちのぽち	内野ぽち	固有人名
うちむらみるく	内村みるく	固有人名
うのせしゅうか	鵜乃瀬朱香	固有人名
うらたまい	浦田麻衣	固有人名
えのきづまお	榎津まお	固有人名
えのきずまお	榎津まお	固有人名	「えのきづまお」の誤り	しない
おうかわみお	桜川未央	固有人名
おうさかかい	桜坂かい	固有人名
おおくぼけんたろう	大久保けんたろう	固有人名
おおしろきょうこ	大城恭子	固有人名
おおのまりな	大野まりな	固有人名
おおばなな	大葉ナナ	固有人名	別表記あり	しない
おおばなな	大庭奈々	固有人名	別表記あり	しない
おかだみお	岡田未央	固有人名
おかもとまや	岡本麻弥	固有人名
おがわくにえ	小川久仁恵	固有人名
おがわゆみこ	小川由美子	固有人名
おきのやすひろ	沖野靖広	固有人名
おくがわくみこ	奥川久美子	固有人名
おくだかおり	奥田香織	固有人名
おくもりかよ	奥森香由	固有人名
おくやまあゆみ	奥山歩	固有人名
おぐらゆい	小倉結衣	固有人名
おさださなえ	長田早苗	固有人名
おだまゆみ	小田真由美	固有人名
おだまり	緒田マリ	固有人名
おだまり	織田真理	固有人名
おだみづき	織田みづき	固有人名
おとのなつみ	音乃菜摘	固有人名
おぼれだにありす	おぼれ谷アリス	固有人名	「おぼれ谷リアス」の誤り	しない	おぼれ谷リアス
おぼれだにりあす	おぼれ谷リアス	固有人名
おぼれたにりあす	おぼれ谷リアス	固有人名	「おぼれだにりあす」の誤り
!! ■か行
かいばらえれな	海原エレナ	固有人名
うなばらえれな	海原エレナ	固有人名	「かいばらえれな」の誤り	しない
かさはらじゅん	笠原准	固有人名
かさはらみお	笠原准	固有人名
かしくられん	柏倉れん	固有人名
かすがりか	春日りか	固有人名
かつきまさこ	勝生真沙子	固有人名
かとうまさみ	加藤昌美	固有人名
かねまつゆか	金松由花	固有人名
かのうとまこ	叶苫子	固有人名
かのみるく	加乃みるく	固有人名
かまたちとせ	鎌田千歳	固有人名
かみじょうめい	上条茗	固有人名
かみむらひな	神村ひな	固有人名
かみむらみや	上村美弥	固有人名
かみべっぷひとし	上別府仁資	固有人名	「びふひとし」の誤り	しない
からさわみつき	柄沢三月	固有人名
かりなまえ	狩那まえ	固有人名
かりなまえ	狩奈まえ	固有人名
かわいおとめ	かわい乙女	固有人名
かわかみともこ	川上とも子	固有人名
かわさきえりこ	川崎恵理子	固有人名
かわしまりの	かわしまりの	固有人名
かわせしのぶ	かわせ志乃	固有人名
かわせゆうこ	川瀬祐子	固有人名
かわせゆづき	川瀬ゆづき	固有人名
かんざきかなり	カンザキカナリ	固有人名
かんざきちひろ	神崎ちひろ	固有人名
かんだくみこ	神田久美子	固有人名
かんだるか	神田るか	固有人名
かんばやしじゅんいち	神林純一	固有人名
きぐちゆり	木口ゆり	固有人名
きさらぎあおい	如月葵	固有人名
きさらぎみこと	如月美琴	固有人名
きさらぎらいむ	如月来夢	固有人名
きしべあや	岸辺亜弥	固有人名
きじまうた	木島宇太	固有人名
きたがわあおい	北川葵	固有人名
きたもりすずめ	北森鈴女	固有人名
きのみひじり	きのみ聖	固有人名
きむらみさ	木村美佐	固有人名
きょうもとしずき	京本しずき	固有人名
きらしょうこ	姫羅翔子	固有人名
きれんざきみこと	季蓮崎みこと	固有人名
きれんざきみこと	季連崎みこと	固有人名
くさかちずる	日下千鶴	固有人名
くさかべひろこ	日下部ひろこ	固有人名
くさやなぎじゅんこ	草柳順子	固有人名
くすのきすずね	楠鈴音	固有人名
くぼたまなみ	くぼた愛美	固有人名
くまがやにーな	熊谷ニーナ	固有人名
くらさわはるか	倉沢はるか	固有人名
くらたまりや	倉田まりや	固有人名
くりたひづる	栗田ひづる	固有人名
くりのきまろん	栗木まろん	固有人名
くりばやしみなみ	栗林みな実	固有人名
くりはらまさこ	栗原雅子	固有人名
くりはらみきこ	栗原みきこ	固有人名
くればやしたくみ	くればやしたくみ	固有人名
こいけたけぞう	小池竹蔵	固有人名
こうづきるな	香月ルナ	固有人名
こおろぎほのか	こおろぎほのか	固有人名
ごぎょうなずな	五行なずな	固有人名
こさかあきら	小坂あきら	固有人名
こさきあん	古崎杏	固有人名
こじまちあき	小島千明	固有人名
こばやしかずみ	小林和実	固有人名
こばやしこうすけ	小林康介	固有人名
このかなみ	このかなみ	固有人名
こんどうまひる	近藤真昼	固有人名
!! ■さ行
さいごうともみ	西郷朋美	固有人名
さえづきまりあ	冴月まりあ	固有人名
さおとめかな	早乙女かな	固有人名
さかきるな	榊るな	固有人名
さかきばらよしこ	榊原良子	固有人名
さかぐちありす	坂口亜梨子	固有人名
さかもとしょうご	坂本正吾	固有人名
さきわれすぷーん	先割れスプーン	固有人名
さくまじゅんこ	佐久間純子	固有人名
さくらぎはるき	桜木ハルキ	固有人名
さくられおな	櫻レオナ	固有人名
さくらいありす	櫻井ありす	固有人名
さくらいしょうこ	桜井翔子	固有人名
さくらいしょうこ	桜井薔子	固有人名
さくらいみれい	桜井美鈴	固有人名
さくらがわみく	桜川美紅	固有人名
さくらがわみどり	桜川みどり	固有人名
ささきあかり	佐々木あかり	固有人名
ささのはづき	笹野葉月	固有人名
ささもりぱんだ	ささもりぱんだ	固有人名
ささもりみえ	笹森美恵	固有人名
さとうちゆき	佐藤千幸	固有人名
さとうまこと	佐藤まこと	固有人名
さとみはるか	里見はるか	固有人名
さもとにりん	佐本二厘	固有人名	「さもとふうり」の誤り	しない
さもとふうり	佐本二厘	固有人名
さわきゆり	澤ゆり	固有人名
さわたりゆい	さわたり由衣	固有人名
しおんみやび	紫苑みやび	固有人名
しずのももか	静野百香	固有人名	別表記あり	しない
しずのももか	静野ももか	固有人名	別表記あり	しない
しづきすみと	紫月澄人	固有人名
しなのあずさ	しなのあずさ	固有人名
しのはらあけみ	篠原あけみ	固有人名
しはらはるか	紫原遥  	固有人名
しぶやひめ	渋谷ひめ	固有人名
しまだかおり	島田香織	固有人名	旧表記	しない
しまだかおり	しまだかおり	固有人名
しまだまなみ	島田愛	固有人名
じむきゃりー	事務台車	固有人名
じむだいしゃ	事務台車	固有人名	「じむきゃりー」の誤り	しない
じゅうもんじはやと	十文字隼人	固有人名
しらいあやの	白井綾乃	固有人名
しろがねぎんこ	白金銀子	固有人名
しろさきひこた	城崎彦太	固有人名
じんぐうじなるみ	神宮時成美	固有人名
しんじょうれみ	新城礼美	固有人名
しんどうまゆみ	新堂真弓	固有人名
しんるうかりん	杏露花梨	固有人名
すがわらあや	菅原文	固有人名
すぎさきかずや	杉崎和哉	固有人名
すずきはるよ	鈴木はるよ	固有人名
すずみともえ	鈴美巴	固有人名
すもとあやな	須本綾奈	固有人名
すやまあきお	陶山章央	固有人名
せきかずみ	関和美	固有人名
せきぐちなつみ	関口なつみ	固有人名
せきどこうじ	関戸浩治	固有人名
せれん	瀬蓮	固有人名
そうまれい	蒼真玲	固有人名
!! ■た行
だいなまいとあみ	ダイナマイト亜美	固有人名
たかおかまさと	高岡政人	固有人名
たかせくるみ	高瀬くるみ	固有人名
たかつきつばさ	高槻つばさ	固有人名
たかのうらら	高乃麗	固有人名
たかはしあきお	高橋あきお	固有人名
たかはしひろき	高橋広樹	固有人名
たかはしみきこ	高橋美紀	固有人名
たかはしゆうき	高橋夕稀	固有人名
たかはしゆうき	高橋裕起	固有人名	旧表記	しない
たかはしゆきの	高橋雪乃	固有人名
たかみやしょうこ	高宮翔子	固有人名
たかむらみずほ	たかむら瑞帆	固有人名
たかむらみずほ	篁瑞帆	固有人名
たかむらゆり	高村優里	固有人名
たきかなこ	滝可南子	固有人名
たけざわゆえ	竹沢由依	固有人名
たけまさひろこ	武政弘子	固有人名
たちかぜかおる	立風薫	固有人名
たちばなあや	立花あや	固有人名
たちばなじゅうしろう	立花十四朗	固有人名
たちばなゆみ	橘裕美	固有人名
たてだえみ	立田恵美	固有人名
たにもとたくみ	谷本卓美	固有人名
たみやすともえ	民安ともえ	固有人名
ちゃたにやすら	茶谷やすら	固有人名
つおいそのか	柘翁そのか	固有人名
つかさこういち	司晃一	固有人名
つじみやはるひこ	辻宮春彦	固有人名
つなみあらし	津波嵐	固有人名
つむぎかなえ	紬叶慧	固有人名
てづかみなこ	手塚美南子	固有人名
てんじんうみ	天神有海	固有人名
とがしけい	富樫ケイ	固有人名
ときわもも	常盤もも	固有人名
とださはる	兎田さはる	固有人名
とびたのぶお	飛田展男	固有人名
とびのくるみ	鳶野くるみ	固有人名
とみざわみちえ	富沢美智恵	固有人名
とりいかのん	鳥居花音	固有人名
!! ■な行
ながいえり	長井絵璃	固有人名
ながさきみなみ	長崎みなみ	固有人名
なかざわあゆむ	中澤歩	固有人名
なかざわあゆむ	中澤アユム	固有人名	旧表記	しない
なかせゆき	中瀬ゆき	固有人名
ながたこずえ	長田梢	固有人名
なかはらありす	中原ありす	固有人名
ながねふみお	長根文緒	固有人名
なかみちみか	仲路未花	固有人名
なかむらのりこ	中村典子	固有人名
なかむらゆみ	中村友美	固有人名
ながもりさえ	永杜紗枝	固有人名
なかやなほ	中家菜穂	固有人名
なかやしほ	中家志穂	固有人名
なしもとゆり	梨本悠里	固有人名
なつかわななみ	夏川菜々美	固有人名
なつきびわ	夏木琵琶	固有人名
なつのひまわり	夏野向日葵	固有人名
なつのほたる	夏野蛍	固有人名
なつみもえ	夏海萌	固有人名
なつめくみ	夏目久美	固有人名
ななおみこと	七生みこと	固有人名
ななせゆう	七星優	固有人名
ななせゆみる	七瀬ゆみる	固有人名
ななせりお	七瀬里緒	固有人名
ななせれん	七瀬恋	固有人名
ななはらことみ	七原ことみ	固有人名
なるせまい	成瀬麻衣	固有人名
なるせるな	成世るな	固有人名
にいやめぐみ	新谷恵	固有人名
にしだこむぎ	西田こむぎ	固有人名
にしのありす	西野ありす	固有人名
にしばたゆみ	西端由美	固有人名
ねこのみるく	猫野みるく	固有人名
のつきまひる	野月まひる	固有人名
ののみやこい	野ノ宮恋	固有人名
ののむらあみ	野々村亜美	固有人名
のもとゆいな	乃本唯名	固有人名
!! ■は行
はざきみなと	葉崎みなと	固有人名
はづきみか	葉月ミカ	固有人名
はとのひな	鳩野比奈	固有人名
はまのなつこ	浜野奈津子	固有人名
はやさかちな	早坂知七	固有人名
はやせあお	早瀬碧	固有人名
はやみようこ	速水陽子	固有人名
はらしまるりこ	原島瑠璃子	固有人名
はるなゆみ	春奈有美	固有人名
はらにしきひろ	原西きひろ	固有人名	別表記あり	しない
はらにしきひろ	原西希京	固有人名	別表記あり	しない
はるのかえる	春野かえる	固有人名
はるのゆきね	春野ゆきね	固有人名
ひきたゆみ	引田有美	固有人名
ひとみはるか	人見はるか	固有人名
ひなきあい	ひなき藍	固有人名
びふひとし	上別府仁資	固有人名
ひめかわあこ	姫川阿子	固有人名
ひゃくたけあきこ	百武彰子	固有人名
ひやまるか	氷山瑠果	固有人名
ひょうがながれ	氷河流	固有人名
ひらたゆきの	平田ゆき乃	固有人名
ひらのきょうこ	平野響子	固有人名
ひるまきょうのすけ	比留間狂ノ介	固有人名
ひろのてら	広野大地	固有人名
ふかいしれい	深石零	固有人名
ふかいはるか	深井晴花	固有人名
ふかみりか	深見梨加	固有人名
ふかみずゆみ	深水由美	固有人名
ふくしまおりね	福島おりね	固有人名
ふくしまななこ	福島菜七子	固有人名
ふくしまもも	福島ももか	固有人名
ふじさわあき	藤澤暁	固有人名
ふじさわあこ	藤沢亜子	固有人名
ふじさわともこ	藤澤智子	固有人名
ふじしろなお	藤代奈央	固有人名
ふじまどか	不二まどか	固有人名
ふちざきゆりこ	渕崎ゆり子	固有人名
へるしーたろう	ヘルシー太郎	固有人名
ほくとみなみ	北都南	固有人名
ほくとみなみ	北斗南	固有人名	「北都南」の誤り	しない
!! ■ま行
まえかわゆうこ	前川優子	固有人名
まきいずみ	まきいずみ	固有人名	「まきいづみ」の誤り	する	まきいづみ
まきいづみ	まきいづみ	固有人名
ましばまり	真柴摩利	固有人名
まついなおこ	松井菜桜子	固有人名
まつながあや	松永亜夜	固有人名
までらつかさ	間寺司	固有人名
まりもりん	まりもりん	固有人名
みえのあみ	三重野亜未	固有人名
みかみゆうこ	三上裕子	固有人名
みきもとあやね	三木本彩響	固有人名
みさきともみ	岬友美	固有人名
みさきりな	三咲里奈	固有人名
みそのあすか	三園あすか	固有人名
みそのおめい	御苑生メイ	固有人名
みづきさなえ	瑞希早苗	固有人名
みづきりん	弥月りん	固有人名
みといずみ	水都いずみ	固有人名
みといずみ	美都いずみ	固有人名	旧表記	しない
みなせりょう	水無瀬凌	固有人名
みなづきゆい	皆附由衣	固有人名
みなみきょうこ	南杏子	固有人名
みなみちはる	南見ちはる	固有人名
みなみなみ	南菜実	固有人名
みなみるい	南るい	固有人名
みやびひめの	雅姫乃	固有人名
むつきりお	睦月里緒	固有人名
むつきりお	睦月理緒 	固有人名	旧表記	しない
むなかたかずし	棟方一志  	固有人名
むらさきばなかおる	紫華薫	固有人名
むらさきばなすみれ	紫華すみれ	固有人名
もえぎゆい	萌木唯	固有人名
もとやまみな	本山美奈	固有人名
ももいいちご	桃井いちご	固有人名
もものこめっと	桃野コメット	固有人名
もりかわあきひろ	森川明大	固有人名
もりかわようこ	森川陽子	固有人名
もりのかりん	森野花梨	固有人名
もりやまあおい	森山葵	固有人名
!! ■や行
やざわいずみ	矢沢泉	固有人名
やしろみなこ	八代美奈子	固有人名
やまさきまき	山咲真紀	固有人名
やまもとひろふみ	ヤマモトヒロフミ	固有人名
ゆいかわみき	唯川みき	固有人名
ゆうきまお	結城麻緒	固有人名
ゆさあゆみ	遊佐あゆみ	固有人名
ゆずきかなめ	柚木かなめ	固有人名
ゆづきさち	柚木サチ	固有人名
ゆなしずか	遊魚静	固有人名
よしかわかな	吉川華生	固有人名
よしださゆり	吉田小百合	固有人名
よしだみほ	吉田美保	固有人名
よしのあかね	吉野茜	固有人名
よねだあつみ	米田貴美	固有人名
!! ■ら行
るつきみらい	瑠月未来	固有人名
るねっさんすやまだ	ルネッサンス山田	固有人名
!! ■わ行
わたなべみさ	渡辺美佐	固有人名
!! ■非姓名形式
あ・ろま	あ・ろま	固有人名
あさり	あさり	固有人名	旧表記	しない
あさり	あさり☆	固有人名
あや	AYA	固有人名
あろま	あ・ろま	固有人名
かおり	歌織	固有人名
きょうか	嬌香	固有人名
きょうこ	杏子	固有人名
くりすちーね	クリスチーネ	固有人名
ことみ	琴実	固有人名
さあや	紗綾	固有人名
さくや	咲也	固有人名
さーや	サーヤ	固有人名
しれん	瀬蓮	固有人名
てんてん	天天	固有人名
とろみ	とろ美	固有人名
ひみこ	比未子	固有人名
ひまり	ヒマリ	固有人名
ねね	寧々	固有人名
まりな	茉莉奈	固有人名
みすみ	みすみ	固有人名
みらう	未来羽	固有人名
れんか	蓮香	固有人名
じゃふうりん	邪風林	固有人名
じゃふうりん	邪封淋	固有人名
じょいまっくす	ジョイまっくす	固有人名
!! ■多名義
!! 【*あおい和紀、碧萌絵、青山ゆかり、浅見ちほ、羽賀ゆい】
あおいもえ	碧萌絵	固有人名	改名	しない	青山ゆかり
あおやまゆかり	青山ゆかり	固有人名	旧名あり	あおい和紀	碧萌絵	浅見ちほ	羽賀ゆい
あさみちほ	浅見ちほ	固有人名	改名	しない	青山ゆかり
はがゆい	羽賀ゆい	固有人名	改名	しない	青山ゆかり
!! 【あおいひとみ、安倍有紀、岩田由貴】
あおいひとみ	あおいひとみ	固有人名	別名あり	しない	安倍有紀	岩田由貴
あべゆき	安倍有紀	固有人名	別名あり	しない	あおいひとみ	岩田由貴
いわたゆき	岩田由貴	固有人名	別名あり	しない	あおいひとみ	安倍有紀
!! 【青川ナガレ、みる】
あおかわながれ	青川ナガレ	固有人名	別名あり	しない	みる
みる	みる	固有人名	別名あり	しない	青川ナガレ
!! 【秋月桃子→佐倉凛】
あきづきももこ	秋月桃子	固有人名	改名	しない	佐倉凛
さくらりん	佐倉凛	固有人名	旧名あり	しない	秋月桃子
!! 【阿谷ほのか、春日恵美】
あたにほのか	阿谷ほのか	固有人名	別名あり	しない	春日恵美
!! ↑「Wind」：Honoka ATANI
あやほのか	阿谷ほのか	固有人名	別名あり	しない	春日恵美
!! ↑「そよかぜのおくりもの」：Honoka Aya
!! 【*朝宮咲、佐伯亜美、観村咲子、三村祥子】
みむらしょうこ	観村咲子	固有人名	別名あり	しない	朝宮咲	佐伯亜美
みむらしょうこ	三村祥子	固有人名	別表記あり	しない
!! 【芦澤友美→葦沢モモ美】
あしざわともみ	芦澤友美	固有人名	改名	しない	葦沢モモ美
あしざわももみ	葦沢モモ美	固有人名	旧名あり	しない	芦澤友美
!! 【綾瀬まゆ、松永雪希、*幸代彩里】
あやせまゆ	綾瀬まゆ	固有人名	別名あり	しない	松永雪希	幸代彩里
まつながゆき	松永雪希	固有人名	別名あり	しない	綾瀬まゆ	幸代彩里
!! 【ありす、かがみありす、*坂口亜梨子、佐々留美子、*国生桜】
ありす	ありす	固有人名	別名あり	しない	かがみありす	坂口亜梨子	佐々留美子	国生桜
かがみありす	かがみありす	固有人名	別名あり	しない	ありす	坂口亜梨子	佐々留美子	国生桜
ささるみこ	佐々留美子	固有人名	別名あり	しない	ありす	かがみありす	坂口亜梨子	国生桜
!! 【生田香織、*風見ひよこ、*中谷あずみ】
いくたかおり	生田香織	固有人名	別名あり	しない	風見ひよこ	中谷あずみ
なまたかおり	生田香織	固有人名	「いくたかおり」の誤り	しない
!! 【伊藤硝子→伊藤麻衣】
いとうしょうこ	伊藤硝子	固有人名	改名	しない	伊藤麻衣
いとうまい	伊藤麻衣	固有人名	別名あり	しない	伊藤硝子
!! 【伊藤瞳子→伊藤麻喜】
いとうとうこ	伊藤瞳子	固有人名	改名	しない	伊藤麻喜
いとうまき	伊藤麻喜	固有人名	別名あり	しない	伊藤瞳子
!! 【稲葉みこ→MI-KO(み〜こ)】
いなばみこ	稲葉みこ	固有人名	改名	しない	MI-KO
みーこ	MI-KO	固有人名	声優用名義・旧名あり	しない	稲葉みこ
みーこ	み〜こ	固有人名	歌用名義	しない
!! 【井村屋さくら、井村屋ほのか、*都ほのか】
いむらやさくら	井村屋さくら	固有人名	別名あり	しない	井村屋ほのか	都ほのか
いむらやほのか	井村屋ほのか	固有人名	別名あり	しない	井村屋さくら	都ほのか
!! 【岩泉まい、樋口まゆ】
いわいずみまい	岩泉まい	固有人名	別名あり	しない	樋口まゆ
ひぐちまゆ	樋口まゆ	固有人名	別名あり	しない	岩泉あみ
!! 【上原ともみ、加古井あや子、月島理緒、*豊田マコト、野々田早苗】
うえはらともみ	上原ともみ	固有人名	別名あり	しない	加古井あや子	月島理緒	豊田マコト	野々田早苗
かこいあやこ	加古井あや子	固有人名	別名あり	しない	上原ともみ	月島理緒	豊田マコト	野々田早苗
つきしまりお	月島理緒 	固有人名	別名あり	しない	上原ともみ	加古井あや子	豊田マコト	野々田早苗
ののださなえ	野々田早苗	固有人名	別名あり	しない	上原ともみ	加古井あや子	月島理緒	豊田マコト
!! 【おおたけしのぶ→本多しの舞】
おおたけしのぶ	おおたけしのぶ	固有人名	改名	しない	本多しの舞
ほんだしのぶ	本多しの舞	固有人名	旧名あり	しない	おおたけしのぶ
!! 【大花どん、ほくとゆりあ】
おおはなどん	大花どん	固有人名	別名あり	しない	ほくとゆりあ
ほくとゆりあ	ほくとゆりあ	固有人名	別名あり	しない	大花どん
!! 【大波こなみ、小島千秋(小鳩千秋)】
おおなみこなみ	大波こなみ	固有人名	別名あり	しない	小島千秋	小鳩千秋
こじまちあき	小島千秋	固有人名	改名	しない	大波こなみ
こじまちあき	小鳩千秋	固有人名	別表記あり	しない
!! 【風音、未来羽】
かざね	風音	固有人名	別名あり	しない	未来羽
みらう	未来羽	固有人名	別名あり	しない	風音
!! 【金田まひる、*安堂りゅう】
かねだまひる	金田まひる	固有人名	別名あり	しない	安堂りゅう
きんたまひる	金田まひる	固有人名	「かねだまひる」の誤り	しない
!! 【春日アン、春波モモ、春乃うらら】
かすがあん	春日アン	固有人名	別名あり	しない	春波モモ	春乃うらら
はるなみもも	春波モモ	固有人名	別名あり	春日アン	春乃うらら
はるのうらら	春乃うらら	固有人名	改名	しない	春日アン
!! 【神無月ほのか→Ruru】
かんなづきほのか	神無月ほのか	固有人名	改名	しない	Ruru
るる	Ruru	固有人名	旧名あり	しない	神無月ほのか
!! 【菊地いほり、菊地しほり】
きくちいほり	菊地いほり	固有人名	別名あり	しない	菊地しほり
きくちしほり	菊地しほり	固有人名	別名あり	しない	菊地いほり
!! 【文月かな、喜多見千里】
きたみちさと	喜多見千里	固有人名	別名あり	しない	文月かな
ふみづきかな	文月かな	固有人名	別名あり	しない	喜多見千里
!! 【木村あやか、*新月初風、むらきあかり】
きむらあやか	木村あやか	固有人名	別名あり	しない	新月初風	むらきあかり
むらきあかり	むらきあかり	固有人名	別名あり	しない	木村あやか	新月初風
!! 【菊理ちさと→涼森ちさと】
くくりちさと	菊理ちさと	固有人名	改名	しない	涼森ちさと
すずもりちさと	涼森ちさと	固有人名	旧名あり	しない	菊理ちさと
!! 【*九条信乃、立花舞、籐野らん(藤野らん)、柳井流海】
たちばなまい	立花舞	固有人名	別名あり	しない	九条信乃	籐野らん	柳井流海
とうのらん	籐野らん	固有人名	別名あり	しない	九条信乃	立花舞	柳井流海
ふじのらん	藤野らん	固有人名	「籐野(とうの)らん」の誤り	しない	籐野らん
やないるみ	柳井流海	固有人名	別名あり	しない	九条信乃	立花舞	籐野らん
!! 【こじまさとみ→児玉さとみ】
こじまさとみ	こじまさとみ	固有人名	改名	しない	児玉さとみ
こだまさとみ	児玉さとみ	固有人名
!! 【木葉楓、橋野さやか、松田理沙】
このはかえで	木葉楓	固有人名	別名あり	しない	橋野さやか	松田理沙
はしのさやか	橋野さやか	固有人名	別名あり	しない	木葉楓	松田理沙
まつだりさ	松田理沙	固有人名	別名あり	しない	木葉楓	橋野さやか
!! 【KOHIRO←福元コヒロ】
こひろ	KOHIRO	固有人名	旧名あり	しない	福元コヒロ
ふくもとこひろ	福元コヒロ	固有人名	改名	しない	KOHIRO
!! 【榊原ゆい、津田沼真利、雛野まよ、Hinano、まりあ】
さかきばらゆい	榊原ゆい	固有人名	旧名あり	しない	津田沼真利	雛野まよ	Hinano	まりあ
つだぬままり	津田沼真利	固有人名	改名	しない	榊原ゆい
ひなのまよ	雛野まよ	固有人名	改名	しない	榊原ゆい
ひなの	Hinano	固有人名	改名	しない	榊原ゆい
まりあ	まりあ	固有人名	改名	しない	榊原ゆい
かしわばらゆい	柏原ゆい	固有人名	「榊原(さかきばら)ゆい」の誤り	しない	榊原ゆい
!! 【さかもとみずき、坂本瑞季、椎名奏子、韮井叶、乃田あす実】
さかもとみずき	さかもとみずき	固有人名	別表記あり	しない
さかもとみずき	坂本瑞季	固有人名	別名あり	しない	椎名奏子	韮井叶	乃田あす実
しいなかなこ	椎名奏子	固有人名	別名あり	しない	さかもとみずき	坂本瑞季	韮井叶	乃田あす実
にらいかない	韮井叶	固有人名	別名あり	しない	乃田あす実	さかもとみずき	椎名奏子	乃田あす実
のだあすみ	乃田あす実	固有人名	別名あり	しない	韮井叶	さかもとみずき	坂本瑞季	椎名奏子
!! 【サトウユキ←冬樹みずほ】
さとうゆき	サトウユキ	固有人名	旧名あり	しない	冬樹みずほ
ふゆきみずほ	冬樹みずほ	固有人名	改名	しない	サトウユキ
!! 【澤木育枝、芹園みや】
さわきいくえ	澤木育枝	固有人名	改名	しない	芹園みや
せりぞのみや	芹園みや	固有人名	旧名あり	しない	澤木育枝
!! 【シィーナ・コウ、手塚まき、*野中みゅう、*森りんご】
てづかまき	手塚まき	固有人名	別名あり	しない	シィーナ・コウ	野中みゅう	森りんご
!! 【清水香、美咲ゆうか、岬ゆうか】
しみずかおり	清水香	固有人名	別名あり	しない	美咲ゆうか	岬ゆうか
みさきゆうか	美咲ゆうか	固有人名	別名あり	しない	清水香
みさきゆうか	岬ゆうか	固有人名	別表記あり	しない
!! 【杉江恵、*早坂知七】
すぎえめぐみ	杉江恵	固有人名	別名あり	しない	早坂知七
!! 【園田まひる→中山ヒカル→理多(Rita)】
そのだまひる	園田まひる	固有人名	改名	しない	中山ヒカル	理多	Rita
なかやまひかる	中山ヒカル	固有人名	別名あり	しない	園田まひる	理多	Rita
りた	理多	固有人名	声優用名義	しない
りた	Rita	固有人名	歌用名義	しない
!! 【鷹月さくら、夏野こおり、*九段綾奈】
たかつきさくら	鷹月さくら	固有人名	別名あり	しない	夏野こおり	九段綾奈
なつのこおり	夏野こおり	固有人名	別名あり	しない	鷹月さくら	九段綾奈
!! 【田中美智←多田美智←みちっち】
ただみとも	多田美智	固有人名	改名	しない	田中美智
たなかみち	田中美智	固有人名	旧名あり	しない	多田美智	みちっち
みちっち	みちっち	固有人名	改名	しない	田中美智
!! 【遠野そよぎ、成瀬ゆら】
とおのそよぎ	遠野そよぎ	固有人名	別名あり	しない	成瀬ゆら
なるせゆら	成瀬ゆら	固有人名	別名あり	しない	遠野そよぎ
!! 【中瀬ひな←村上仁美】
なかせひな	中瀬ひな	固有人名	旧名あり	しない	村上仁美
むらかみひとみ	村上仁美	固有人名	改名	しない	中瀬ひな
!! 【仲西みあ→成瀬未亜】
なかにしみあ	仲西みあ	固有人名	改名	しない	成瀬未亜
なるせみあ	成瀬未亜	固有人名	旧名あり	しない	仲西みあ
!! 【*芹澤綾、野神奈々、野上奈々、葉月ユカ、*村井静代】
のがみなな	野神奈々	固有人名	別名あり	しない	芹澤綾	葉月ユカ	村井静代
のがみなな	野上奈々	固有人名	別表記あり
はづきゆか	葉月ユカ	固有人名	別名あり	しない	芹澤綾	野神奈々	野上奈々	村井静代
!! 【羽桜涼子、宗川梗】
はざくらりょうこ	羽桜涼子	固有人名	別名あり	しない	宗川梗
むねかわきょう	宗川梗	固有人名	別名あり	しない	羽桜涼子
!! 【春野日和、ひなたぼっ子】
はるのひより	春野日和	固有人名	別名あり	しない	ひなたぼっ子
ひなたぼっこ	ひなたぼっ子	固有人名	別名あり	しない	春野日和
!! 【東十条明日香、北条明日香】
ひがしじゅうじょうあすか	東十条明日香	固有人名	別名あり	しない	北条明日香
ほうじょうあすか	北条明日香	固有人名	別名あり	しない	東十条明日香
!! 【日向裕羅←西村ひな】
ひなたゆら	日向裕羅	固有人名	旧名あり	しない	西村ひな
にしむらひな	西村ひな	固有人名	改名	しない	日向裕羅
!! 【堀奈生、*長澤仁美、*更科りえ】
ほりなお	堀奈生	固有人名	別名あり	しない	長澤仁美	更科りえ
!! 【本条真琴】
ほんじょうまこと	本条真琴	固有人名	引退により改名	しない	うなっち
ほんじょうまこと	本上真琴	固有人名	旧表記	しない
!! 【PON、YUKI、風華、川部法子、小鳥田麗子、島香麗子、ミルキーゆかり】
ぽん	PON	固有人名	別名あり	しない	YUKI	風華	川部法子	小鳥田麗子	島香麗子
ゆき	YUKI	固有人名	別名あり	しない	PON	風華	川部法子	小鳥田麗子	島香麗子
ふうか	風華	固有人名	別名あり	しない	PON	YUKI	川部法子	小鳥田麗子	島香麗子
かわべのりこ	川部法子	固有人名	別名あり	しない	PON	YUKI	風華	小鳥田麗子	島香麗子
ことりだれいこ	小鳥田麗子	固有人名	別名あり	しない	PON	YUKI	風華	川部法子	島香麗子
しまかれいこ	島香麗子	固有人名	別名あり	しない	PON	YUKI	風華	川部法子	小鳥田麗子
みるきーゆかり	ミルキーゆかり	固有人名	別名あり	しない	PON	YUKI	風華	川部法子	小鳥田麗子
!! 【もっち←紗梨子】
もっち	もっち	固有人名	旧名あり	しない	紗梨子
しゃりこ	紗梨子	固有人名	改名	しない	もっち
!! 【萌原ぷりん系】
もえはらぶり	萌原ぶり	固有人名	共有名義	しない	萌原ぷりん	萌原ぷりりん
もえはらぷりりん	萌原ぷりりん	固有人名	共有名義	しない	萌原ぷりん	萌原ぶり
もえはらぷりん	萌原ぷりん	固有人名	共有名義	しない	萌原ぶり	萌原ぷりりん

!! ◆一般作・関連作品
!! （声優相性診断所( http://tomoch.s28.xrea.com/ )の辞書との併用をお勧めします）
!! ■あ行
あおきさやか	あおきさやか	固有人名
あおきしずか	青木静香	固有人名	改名	しない	あおきさやか
あさみじゅんこ	麻見順子	固有人名
あだちまり	安達まり	固有人名
あらいしずか	荒井静香	固有人名	旧名あり	しない	北条静香
いいじまきょうこ	飯島京子	固有人名	旧表記	しない
いいじまきょうこ	飯島杏子	固有人名
いのくちゆか	猪口有佳	固有人名
いまいゆか	今井由香	固有人名
いわいゆきこ	岩居由希子	固有人名
いわいゆきこ	岩井由希子	固有人名	旧表記	しない
いわおじゅんこ	岩男潤子	固有人名
いわつぼりえ	岩坪理江	固有人名
うちかわあい	内川藍維	固有人名
えばたいくこ	江幡育子	固有人名
えんどうさとこ	遠藤さとこ	固有人名	改名	しない	東風たまこ
おのりょうこ	小野涼子	固有人名
おりかさあい	折笠愛	固有人名
!! ■か行
かじたゆうき	梶田夕貴	固有人名
かどわきまい	門脇舞	固有人名
かないみか	かないみか	固有人名
かわむらたくお	川村拓央	固有人名
こいけかのこ	小池かの子	固有人名	改名	しない	幡宮かのこ
こうづきみわ	倖月美和	固有人名
こおろぎさとみ	こおろぎさとみ	固有人名
こぐれえま	小暮英麻	固有人名
こちたまこ	東風たまこ	固有人名	旧名あり	しない	遠藤さとこ
ごとうまい	後藤麻衣	固有人名
ごとうゆうこ	後藤邑子	固有人名
こやまきみこ	古山きみこ	固有人名	旧表記	しない
こやまきみこ	こやまきみこ	固有人名
!! ■さ行
さいがみつき	斎賀みつき	固有人名
さくまれいこ	佐久間レイ	固有人名
さとうみかこ	佐藤美佳子	固有人名
さやまりこ	茶山莉子	固有人名
しずきあみ	静木亜美	固有人名
さんごみなこ	三五美奈子	固有人名
しのはらえみ	篠原恵美	固有人名
そのざきみえ	園崎未恵	固有人名	声優用表記	しない
そのざきみえ	そのざきみえ	固有人名	ナレーション用表記	しない
!! ■た行
たかだゆみ	高田由美	固有人名
たかのなおこ	高野直子	固有人名
たなかりょうこ	田中涼子	固有人名
!! ■な行
なかたじゅんこ	中田順子	固有人名
ながさわみき	長沢美樹	固有人名
ながせいくみ	永瀬いくみ	固有人名	改名	しない	永瀬江美弥
ながせえみや	永瀬江美弥	固有人名	旧名あり	しない	永瀬いくみ
ながみはるか	永見はるか	固有人名
なつきりお	夏樹リオ	固有人名
なばためひとみ	生天目仁美	固有人名
なるみえりか	鳴海エリカ	固有人名	旧名あり	しない	本田千秋
にしむらちなみ	西村ちなみ	固有人名
のなかかおり	野中カオリ	固有人名
ののせみお	野々瀬ミオ	固有人名
!! ■は行
はたみやかのこ	幡宮かのこ	固有人名	旧名あり	しない	小池かの子
ひらいりこ	平井理子	固有人名
ひらまつあきこ	平松晶子	固有人名
ふじさきかおり	藤咲かおり	固有人名
ふじたなつみ	藤田夏海	固有人名
ほうじょうしずか	北条静香	固有人名	改名	しない	荒井静香
ほしのちずこ	星野千寿子	固有人名
ほんだちあき	本田千秋	固有人名	改名	しない	鳴海エリカ
ほんだちえこ	本多知恵子	固有人名
ほんまゆかり	本間ゆかり	固有人名
!! ■ま行
みずたにゆうこ	水谷優子	固有人名
みついしことの	三石琴乃	固有人名
みやむらゆうこ	宮村優子	固有人名
むたあきこ	むたあきこ	固有人名
もといえみ	本井えみ	固有人名
もといえみ	本井英美	固有人名	旧表記	しない
!! ■や行
ゆいもとみちる	結本ミチル	固有人名
よこおまり	横尾まり	固有人名
よこてくみこ	横手久美子	固有人名	改名	しない	氷青
よしだこなみ	吉田小南美	固有人名
!! ■ら行
りきまるのりこ	力丸乃りこ	固有人名
!! ■わ行
わだかよ	和田カヨ	固有人名
!! ■非姓名形式
ひとみ	ひと美	固有人名
ひょうせい	氷青	固有人名	旧名あり	しない	横手久美子
!! ■多名義
!! 【友永朱音、中村恵子、長谷川舞、森野ことり】
ともながあかね	友永朱音	固有人名	旧名あり	しない	中村恵子	長谷川舞	森野ことり
なかむらけいこ	中村恵子	固有人名	改名	友永朱音
はせがわまい	長谷川舞	固有人名	改名	友永朱音
もりのことり	森野ことり	固有人名	改名	友永朱音
