!!ATOK_TANGO_TEXT_HEADER_1
!! 18禁ゲーム声優辞書 for ATOK2005
!! 2007年05月12日版　No.2：姓名辞書

!! ■苗字：あ行
あいら	愛羅	固有人姓
あおい	碧	固有人姓
あおい	あおい	固有人姓
あおい	青泉	固有人姓
あおき	あおき	固有人姓
あおの	青野	固有人姓
あおば	青葉	固有人姓
あおやま	青山	固有人姓
あかい	赤威	固有人姓
あかい	赤井	固有人姓
あかがわ	あかがわ	固有人姓
あかぎ	赤城	固有人姓
あかし	赤白	固有人姓
あきづき	秋月	固有人姓
あぐみ	安玖深	固有人姓
あさき	朝咲	固有人姓
あさと	浅都	固有人姓
あさみ	麻見	固有人姓
あさみ	浅海	固有人姓
あしざわ	芦澤	固有人姓
あしざわ	葦沢	固有人姓
あそう	麻生	固有人姓
あそう	亜蒼	固有人姓
あだち	安達	固有人姓
あたに	阿谷	固有人姓
あまくに	雨邦	固有人姓
あまね	天音	固有人姓
あまみや	雨宮	固有人姓
あやかわ	綾川	固有人姓
あやせ	彩世	固有人姓
あやせ	綾瀬	固有人姓
あやのこうじ	綾小路	固有人姓
あゆかわ	鮎川	固有人姓
あらい	荒井	固有人姓
あらかわ	荒川	固有人姓
ありぞの	有園	固有人姓
いいじま	飯島	固有人姓
いいだ	飯田	固有人姓
いし	石	固有人姓
いしづか	石塚	固有人姓
いずみ	和泉	固有人姓
いちじょう	一条	固有人姓
いちのみや	一宮	固有人姓
いっしき	一色	固有人姓
いとう	伊藤	固有人姓
いなば	稲葉	固有人姓
いのうえ	井上	固有人姓
いまい	今井	固有人姓
いむらや	井村屋	固有人姓
いわい	岩居	固有人姓
いわい	岩井	固有人姓
いわお	岩男	固有人姓
いわお	巌	固有人姓
いわき	岩城	固有人姓
いわた	岩田	固有人姓
いわつぼ	岩坪	固有人姓
いわもと	岩本	固有人姓
うえ	うえ	固有人姓
うえい	上井	固有人姓
うたの	唄野	固有人姓
うちかわ	内川	固有人姓
うちむら	内村	固有人姓
うのせ	鵜乃瀬	固有人姓
うらた	浦田	固有人姓
えのきづ	榎津	固有人姓
えばた	江幡	固有人姓
おうかわ	桜川	固有人姓
おうさか	桜坂	固有人姓
おおくぼ	大久保	固有人姓
おおしろ	大城	固有人姓
おおなみ	大波	固有人姓
おおの	大野	固有人姓
おおば	大葉	固有人姓
おおば	大庭	固有人姓
おおはな	大花	固有人姓
おかだ	岡田	固有人姓
おかもと	岡本	固有人姓
おがわ	小川	固有人姓
おくもり	奥森	固有人姓
おぐら	小倉	固有人姓
おだ	織田	固有人姓
おだ	緒田	固有人姓
おだ	小田	固有人姓
おとの	音乃	固有人姓
おぼれだに	おぼれ谷	固有人姓
おりかさ	折笠	固有人姓

!! ■苗字：か行
かいばら	海原	固有人姓
かさはら	笠原	固有人姓
かしくら	柏倉	固有人姓
かじた	梶田	固有人姓
かすが	春日	固有人姓
かつき	勝生	固有人姓
かとう	加藤	固有人姓
かどわき	門脇	固有人姓
かない	かない	固有人姓
かねだ	金田	固有人姓
かのう	叶	固有人姓
かみじょう	上条	固有人姓
かみむら	神村	固有人姓
かみむら	上村	固有人姓
からさわ	柄沢	固有人姓
かりな	狩那	固有人姓
かりな	狩奈	固有人姓
かわい	かわい	固有人姓
かわかみ	川上	固有人姓
かわさき	川崎	固有人姓
かわしま	かわしま	固有人姓
かわせ	川瀬	固有人姓
かわせ	かわせ	固有人姓
かわべ	川部	固有人姓
かんざき	神崎	固有人姓
かんざき	カンザキ	固有人姓
かんだ	神田	固有人姓
かんなづき	神無月	固有人姓
かんばやし	神林	固有人姓
きくち	菊地	固有人姓
きぐち	木口	固有人姓
きさらぎ	如月	固有人姓
きしべ	岸辺	固有人姓
きたがわ	北川	固有人姓
きたみ	喜多見	固有人姓
きむら	木村	固有人姓
きょうもと	京本	固有人姓
きら	姫羅	固有人姓
きれんざき	季連崎	固有人姓
きれんざき	季蓮崎	固有人姓
きんた	金田	固有人姓
くくり	菊理	固有人姓
くさかべ	日下部	固有人姓
くさやなぎ	草柳	固有人姓
くすのき	楠	固有人姓
くぼた	くぼた	固有人姓
くまがや	熊谷	固有人姓
くりた	栗田	固有人姓
くりのき	栗木	固有人姓
くりばやし	栗林	固有人姓
くりはら	栗原	固有人姓
くればやし	くればやし	固有人姓
こいけ	小池	固有人姓
こうづき	香月	固有人姓
こうづき	倖月	固有人姓
こおろぎ	こおろぎ	固有人姓
こさか	小坂	固有人姓
こじま	小島	固有人姓
こじま	こじま	固有人姓
こだま	児玉	固有人姓
ことりだ	小鳥田	固有人姓
この	この	固有人姓
このは	木葉	固有人姓
こやま	こやま	固有人姓
こやま	古山	固有人姓
こんどう	近藤	固有人姓

!! ■苗字：さ行
さいが	斎賀	固有人姓
さいごう	西郷	固有人姓
さえづき	冴月	固有人姓
さおとめ	早乙女	固有人姓
さかき	榊	固有人姓
さかきばら	榊原	固有人姓
さかぐち	坂口	固有人姓
さかもと	坂本	固有人姓
さかもと	さかもと	固有人姓
さくま	佐久間	固有人姓
さくら	櫻	固有人姓
さくら	佐倉	固有人姓
さくらい	桜井	固有人姓
さくらがわ	桜川	固有人姓
ささ	佐々	固有人姓
ささき	佐々木	固有人姓
ささの	笹野	固有人姓
ささもり	笹森	固有人姓
ささもり	ささもり	固有人姓
さとう	佐藤	固有人姓
さとみ	里見	固有人姓
さやま	茶山	固有人姓
さわき	澤木	固有人姓
さわたり	さわたり	固有人姓
さんご	三五	固有人姓
しいな	椎名	固有人姓
しおん	紫苑	固有人姓
しずき	静木	固有人姓
しずの	静野	固有人姓
しなの	しなの	固有人姓
しのはら	篠原	固有人姓
しまか	島香	固有人姓
しまだ	島田	固有人姓
しまだ	しまだ	固有人姓
しみず	清水	固有人姓
じゅうもんじ	十文字	固有人姓
しらい	白井	固有人姓
じんぐうじ	神宮時	固有人姓
しんじょう	新城	固有人姓
しんどう	新堂	固有人姓
しんるう	杏露	固有人姓
すがわら	菅原	固有人姓
すぎえ	杉江	固有人姓
すずき	鈴木	固有人姓
すずみ	鈴美	固有人姓
すずもり	涼森	固有人姓
すもと	須本	固有人姓
すやま	陶山	固有人姓
せき	関	固有人姓
せきぐち	関口	固有人姓
せきど	関戸	固有人姓
せりぞの	芹園	固有人姓
そうま	蒼真	固有人姓
そのざき	園崎	固有人姓
そのざき	そのざき	固有人姓

!! ■苗字：た行
だいなまいと	ダイナマイト	固有人姓
たかおか	高岡	固有人姓
たかせ	高瀬	固有人姓
たかだ	高田	固有人姓
たかつき	鷹月	固有人姓
たかつき	高槻	固有人姓
たかの	高野	固有人姓
たかの	高乃	固有人姓
たかみや	高宮	固有人姓
たかむら	篁	固有人姓
たかむら	たかむら	固有人姓
たかむら	高村	固有人姓
たき	滝	固有人姓
たけざわ	竹沢	固有人姓
たけまさ	武政	固有人姓
ただ	多田	固有人姓
たちかぜ	立風	固有人姓
たちばな	立花	固有人姓
たちばな	橘	固有人姓
たてだ	立田	固有人姓
たなか	田中	固有人姓
たにもと	谷本	固有人姓
ちゃたに	茶谷	固有人姓
つおい	柘翁	固有人姓
つじみや	辻宮	固有人姓
つだぬま	津田沼	固有人姓
つむぎ	紬	固有人姓
てづか	手塚	固有人姓
てんじん	天神	固有人姓
とうの	籐野	固有人姓
とだ	兎田	固有人姓
とびた	飛田	固有人姓
とびの	鳶野	固有人姓
とみざわ	富沢	固有人姓
ともなが	友永	固有人姓
とりい	鳥居	固有人姓

!! ■苗字：な行
ながい	長井	固有人姓
ながさき	長崎	固有人姓
なかざわ	中澤	固有人姓
ながさわ	長沢	固有人姓
なかせ	中瀬	固有人姓
ながせ	永瀬	固有人姓
ながた	長田	固有人姓
なかにし	中西	固有人姓
ながね	長根	固有人姓
ながみ	永見	固有人姓
なかみち	仲路	固有人姓
なかむら	中村	固有人姓
なかや	中家	固有人姓
なしもと	梨本	固有人姓
なつかわ	夏川	固有人姓
なつき	夏木	固有人姓
なつの	夏野	固有人姓
なつみ	夏海	固有人姓
ななせ	七瀬	固有人姓
なばため	生天目	固有人姓
なるせ	成瀬	固有人姓
なるせ	成世	固有人姓
なるみ	鳴海	固有人姓
にいや	新谷	固有人姓
にしだ	西田	固有人姓
にしの	西野	固有人姓
にしばた	西端	固有人姓
にしむら	西村	固有人姓
ねこの	猫野	固有人姓
のがみ	野神	固有人姓
のがみ	野上	固有人姓
のだ	乃田	固有人姓
のつき	野月	固有人姓
ののだ	野々田	固有人姓
ののむら	野々村	固有人姓
のもと	乃本	固有人姓

!! ■苗字：は行
はざき	葉崎	固有人姓
はせがわ	長谷川	固有人姓
はたみや	幡宮	固有人姓
はづき	葉月	固有人姓
はとの	鳩野	固有人姓
はまの	浜野	固有人姓
はやさか	早坂	固有人姓
はやせ	早瀬	固有人姓
はやみ	速水	固有人姓
はらしま	原島	固有人姓
はらにし	原西	固有人姓
はるの	春野	固有人姓
はるの	春乃	固有人姓
ひがしじゅうじょう	東十条	固有人姓
ひきた	引田	固有人姓
ひとみ	人見	固有人姓
ひなた	日向	固有人姓
びふ	上別府	固有人姓
ひめかわ	姫川	固有人姓
ひゃくたけ	百武	固有人姓
ひやま	氷山	固有人姓
ひょうが	氷河	固有人姓
ひらた	平田	固有人姓
ひらまつ	平松	固有人姓
ふかい	深井	固有人姓
ふかみ	深見	固有人姓
ふかみず	深水	固有人姓
ふくしま	福島	固有人姓
ふくもと	福元	固有人姓
ふじさき	藤咲	固有人姓
ふじさわ	藤澤	固有人姓
ふじさわ	藤沢	固有人姓
ふじしろ	藤代	固有人姓
ふじた	藤田	固有人姓
ふじの	藤野	固有人姓
ふちざき	渕崎	固有人姓
ふみづき	文月	固有人姓
ふゆき	冬樹	固有人姓
ほうじょう	北条	固有人姓
ほくと	北都	固有人姓
ほくと	北斗	固有人姓
ほしの	星野	固有人姓
ほり	堀	固有人姓
ほんじょう	本条	固有人姓
ほんじょう	本上	固有人姓
ほんだ	本多	固有人姓
ほんま	本間	固有人姓

!! ■苗字：ま行
まえかわ	前川	固有人姓
まき	まき	固有人姓
ましば	真柴	固有人姓
まつい	松井	固有人姓
まつなが	松永	固有人姓
みえの	三重野	固有人姓
みかみ	三上	固有人姓
みきもと	三木本	固有人姓
みさき	岬	固有人姓
みさき	美咲	固有人姓
みずたに	水谷	固有人姓
みその	三園	固有人姓
みそのお	御苑生	固有人姓
みついし	三石	固有人姓
みづき	瑞希	固有人姓
みづき	弥月	固有人姓
みと	美都	固有人姓
みと	水都	固有人姓
みなせ	水無瀬	固有人姓
みなづき	皆附	固有人姓
みなみ	南見	固有人姓
みなみ	南	固有人姓
みむら	観村	固有人姓
みやむら	宮村	固有人姓
みるきー	ミルキー	固有人姓
むた	むた	固有人姓
むつき	睦月	固有人姓
むらかみ	村上	固有人姓
むらさきばな	紫華	固有人姓
もえぎ	萌木	固有人姓
もえはら	萌原	固有人姓
もとい	本井	固有人姓
もとやま	本山	固有人姓
ももの	桃野	固有人姓
もりかわ	森川	固有人姓
もりの	森野	固有人姓
もりやま	森山	固有人姓

!! ■苗字：や行
やざわ	矢沢	固有人姓
やしろ	八代	固有人姓
やない	柳井	固有人姓
やまさき	山咲	固有人姓
ゆいかわ	唯川	固有人姓
ゆうき	結城	固有人姓
ゆさ	遊佐	固有人姓
ゆな	遊魚	固有人姓
よこお	横尾	固有人姓
よこて	横手	固有人姓
よしかわ	吉川	固有人姓
よしだ	吉田	固有人姓
よしの	吉野	固有人姓
よねだ	米田	固有人姓

!! ■苗字：ら行
るねっさんす	ルネッサンス	固有人姓

!! ■苗字：わ行
わだ	和田	固有人姓
わたなべ	渡辺	固有人姓

!! ■名前：あ行
あい	愛	固有人名
あい	藍維	固有人名
あお	碧	固有人名
あおい	葵	固有人名
あおい	あおい	固有人名
あかね	朱音	固有人名
あかね	茜	固有人名
あかり	あかり	固有人名
あき	暁	固有人名
あきお	あきお	固有人名
あきお	章央	固有人名
あきこ	晶子	固有人名
あきこ	あきこ	固有人名
あきこ	彰子	固有人名
あきひろ	明大	固有人名
あきら	あきら	固有人名
あけみ	あけみ	固有人名
あこ	阿子	固有人名
あこ	亜子	固有人名
あすか	あすか	固有人名
あすか	明日香	固有人名
あずさ	あずさ	固有人名
あすみ	あす実	固有人名
あつみ	貴美	固有人名
あみ	亜美	固有人名
あみ	亜未	固有人名
あや	文	固有人名
あや	亜弥	固有人名
あやか	あやか	固有人名
あやな	綾奈	固有人名
あやね	彩響	固有人名
あやの	綾乃	固有人名
あゆみ	あゆみ	固有人名
あゆむ	歩	固有人名
あゆむ	アユム	固有人名
ありす	アリス	固有人名
ありす	亜梨子	固有人名
ありす	ありす	固有人名
あんな	アン	固有人名
あんな	杏奈	固有人名
いくえ	育枝	固有人名
いくこ	育子	固有人名
いくみ	いくみ	固有人名
いずみ	泉	固有人名
いずみ	いずみ	固有人名
いづみ	いづみ	固有人名
いほり	いほり	固有人名
うみ	有海	固有人名
うらら	麗	固有人名
うらら	うらら	固有人名
えま	英麻	固有人名
えみ	恵美	固有人名
えみ	えみ	固有人名
えみや	江美弥	固有人名
えり	絵璃	固有人名
えりか	エリカ	固有人名
えりこ	恵理子	固有人名
えれな	エレナ	固有人名
おと	音	固有人名
おとめ	乙女	固有人名
おりね	おりね	固有人名

!! ■名前：か行
かい	かい	固有人名
かえで	楓	固有人名
かえる	かえる	固有人名
かおり	かおり	固有人名
かおり	香	固有人名
かおり	香織	固有人名
かおる	薫	固有人名
かずき	和樹	固有人名
かずみ	和美	固有人名
かずや	和矢	固有人名
かな	華生	固有人名
かな	かな	固有人名
かなえ	叶慧	固有人名
かなこ	奏子	固有人名
かなこ	可南子	固有人名
かなみ	かなみ	固有人名
かなり	カナリ	固有人名
かのこ	かの子	固有人名
かのこ	かのこ	固有人名
かのん	花音	固有人名
かよ	カヨ	固有人名
かよ	香由	固有人名
かりん	花梨	固有人名
きひろ	希京	固有人名
きひろ	きひろ	固有人名
きみこ	きみこ	固有人名
きょうこ	杏子	固有人名
きょうこ	恭子	固有人名
きょうこ	京子	固有人名
くう	空	固有人名
くにえ	久仁恵	固有人名
くみこ	久美子	固有人名
くるみ	くるみ	固有人名
けいこ	恵子	固有人名
けんたろう	けんたろう	固有人名
こうじ	浩治	固有人名
こずえ	梢	固有人名
ことの	琴乃	固有人名
ことり	ことり	固有人名
こなみ	こなみ	固有人名
こひろ	コヒロ	固有人名
こむぎ	こむぎ	固有人名
こめっと	コメット	固有人名

!! ■名前：さ行
さかな	さかな	固有人名
さくら	さくら	固有人名
さくら	桜	固有人名
さとみ	さとみ	固有人名
さなえ	早苗	固有人名
さはる	さはる	固有人名
さやか	さやか	固有人名
さゆり	小百合	固有人名
しずか	静	固有人名
しずか	静香	固有人名
しずき	しずき	固有人名
しのぶ	忍	固有人名
しのぶ	志乃	固有人名
しほり	しほり	固有人名
しゅうか	朱香	固有人名
じゅうしろう	十四朗	固有人名
じゅんいち	純一	固有人名
じゅんこ	純子	固有人名
じゅんこ	潤子	固有人名
じゅんこ	順子	固有人名
しょうこ	薔子	固有人名
しょうこ	咲子	固有人名
しょうこ	硝子	固有人名
しょうこ	翔子	固有人名
すずね	鈴音	固有人名
ぜんしゅう	蝉秋	固有人名
そのか	そのか	固有人名
そよ	そよ	固有人名
そら	そら	固有人名

!! ■名前：た行
たくみ	たくみ	固有人名
たくみ	卓美	固有人名
ちあき	千秋	固有人名
ちあき	千明	固有人名
ちえこ	知恵子	固有人名
ちさと	千里	固有人名
ちさと	ちさと	固有人名
ちずこ	千寿子	固有人名
ちな	知七	固有人名
ちなみ	ちなみ	固有人名
ちはる	ちはる	固有人名
ちひろ	ちひろ	固有人名
ちゆき	千幸	固有人名
つかさ	司	固有人名
つばさ	つばさ	固有人名
てら	大地	固有人名
とうこ	桐子	固有人名
とうこ	瞳子	固有人名
とおる	亨	固有人名
ときひこ	時彦	固有人名
とまこ	苫子	固有人名
とまと	とまと	固有人名
ともえ	巴	固有人名
ともこ	とも子	固有人名
ともこ	智子	固有人名
ともみ	友美	固有人名
ともみ	朋美	固有人名
ともみ	ともみ	固有人名
どん	どん	固有人名

!! ■名前：な行
なお	奈生	固有人名
なお	奈央	固有人名
なおこ	菜桜子	固有人名
なおこ	直子	固有人名
ながれ	流	固有人名
なつこ	奈津子	固有人名
なつみ	夏海	固有人名
なつみ	菜摘	固有人名
なつみ	奈津美	固有人名
なつみ	なつみ	固有人名
なな	奈々	固有人名
なな	ナナ	固有人名
ななこ	菜七子	固有人名
ななみ	菜々美	固有人名
なの	ナノ	固有人名
なほ	菜穂	固有人名
なみ	菜実	固有人名
なるみ	成美	固有人名
にーな	ニーナ	固有人名
のぞみ	のぞみ	固有人名
のぶお	展男	固有人名
のりこ	法子	固有人名
のりこ	典子	固有人名

!! ■名前：は行
はじめ	一	固有人名
はづき	葉月	固有人名
はやと	隼人	固有人名
はるか	はるか	固有人名
はるか	晴花	固有人名
はるひこ	春彦	固有人名
はるよ	はるよ	固有人名
ぱんだ	ぱんだ	固有人名
ひかる	ヒカル	固有人名
ひづる	ひづる	固有人名
ひとし	仁資	固有人名
ひとみ	仁美	固有人名
ひな	ひな	固有人名
ひな	比奈	固有人名
ひなた	ひなた	固有人名
ひまわり	向日葵	固有人名
ひより	日和	固有人名
ひろき	広樹	固有人名
ひろこ	ひろこ	固有人名
ひろこ	弘子	固有人名
びわ	琵琶	固有人名
ふうり	二厘	固有人名
ふみ	歩未	固有人名
ふみお	文緒	固有人名
ぶり	ぶり	固有人名
ぷりりん	ぷりりん	固有人名
ぷりん	ぷりん	固有人名
ほたる	蛍	固有人名
ぽち	ぽち	固有人名
ほのか	ほのか	固有人名

!! ■名前：ま行
まい	麻衣	固有人名
まえ	まえ	固有人名
まお	まお	固有人名
まお	麻緒	固有人名
まき	真紀	固有人名
まき	まき	固有人名
まき	麻喜	固有人名
まこと	真琴	固有人名
まさこ	雅子	固有人名
まさこ	真沙子	固有人名
まさたけ	正武	固有人名
まさと	政人	固有人名
まさみ	昌美	固有人名
まなみ	愛美	固有人名
まひる	まひる	固有人名
まひる	真昼	固有人名
まや	麻弥	固有人名
まゆみ	真由美	固有人名
まゆみ	真弓	固有人名
まり	真利	固有人名
まり	マリ	固有人名
まり	真理	固有人名
まり	摩利	固有人名
まりあ	まりあ	固有人名
まりな	まりな	固有人名
まろん	まろん	固有人名
みあ	みあ	固有人名
みあ	未亜	固有人名
みえ	美絵	固有人名
みえ	美恵	固有人名
みえ	未恵	固有人名
みえ	みえ	固有人名
みお	未央	固有人名
みお	准	固有人名
みか	未花	固有人名
みか	みか	固有人名
みか	ミカ	固有人名
みかこ	美佳子	固有人名
みき	美樹	固有人名
みき	みき	固有人名
みきこ	みきこ	固有人名
みきこ	美紀	固有人名
みこ	みこ	固有人名
みこと	美琴	固有人名
みこと	みこと	固有人名
みさ	美佐	固有人名
みずほ	みずほ	固有人名
みずほ	瑞帆	固有人名
みち	美智	固有人名
みちえ	美智恵	固有人名
みちる	みちる	固有人名
みつき	みつき	固有人名
みつき	三月	固有人名
みづき	みづき	固有人名
みづき	瑞季	固有人名
みとも	美智	固有人名
みどり	みどり	固有人名
みな	美奈	固有人名
みなこ	美奈子	固有人名
みなこ	美南子	固有人名
みなと	みなと	固有人名
みなみ	みなみ	固有人名
みなみ	みな実	固有人名
みなみ	南	固有人名
みほ	美保	固有人名
みや	みや	固有人名
みや	美弥	固有人名
みやび	みやび	固有人名
みゅう	みゅう	固有人名
みゅん	みゅん	固有人名
みるく	みるく	固有人名
みれい	美鈴	固有人名
みわ	美和	固有人名
みーな	みーな	固有人名
めい	メイ	固有人名
めい	茗	固有人名
もえ	萌絵	固有人名
もも	もも	固有人名
ももか	ももか	固有人名
ももか	桃香	固有人名
ももか	百香	固有人名
ももこ	桃子	固有人名
ももみ	モモ美	固有人名

!! ■名前：や行
やすら	やすら	固有人名
やまだ	山田	固有人名
ゆい	ゆい	固有人名
ゆい	由衣	固有人名
ゆい	結衣	固有人名
ゆいな	唯名	固有人名
ゆう	ゆう	固有人名
ゆうか	ゆうか	固有人名
ゆうき	夕稀	固有人名
ゆうき	裕起	固有人名
ゆうき	夕貴	固有人名
ゆうこ	優子	固有人名
ゆうこ	祐子	固有人名
ゆうこ	裕子	固有人名
ゆうこ	邑子	固有人名
ゆうり	悠里	固有人名
ゆえ	由依	固有人名
ゆか	由香	固有人名
ゆかり	ゆかり	固有人名
ゆき	ゆき	固有人名
ゆき	由貴	固有人名
ゆき	雪希	固有人名
ゆきこ	由希子	固有人名
ゆきね	ゆきね	固有人名
ゆきの	ゆき乃	固有人名
ゆきの	雪乃	固有人名
ゆずる	譲	固有人名
ゆづき	ゆづき	固有人名
ゆな	由奈	固有人名
ゆみ	由美	固有人名
ゆみ	友美	固有人名
ゆみ	裕美	固有人名
ゆみ	有美	固有人名
ゆみこ	由美子	固有人名
ゆみる	ゆみる	固有人名
ゆら	裕羅	固有人名
ゆり	ゆり	固有人名
ゆり	優里	固有人名
ゆりこ	ゆり子	固有人名
ようこ	陽子	固有人名
ようこ	葉子	固有人名
よしこ	良子	固有人名

!! ■名前：ら行
らいむ	来夢	固有人名
らん	らん	固有人名
りあす	リアス	固有人名
りえ	理江	固有人名
りお	里緒	固有人名
りお	理緒 	固有人名
りか	里夏	固有人名
りか	梨加	固有人名
りゅう	琉	固有人名
りょう	凌	固有人名
るか	瑠果	固有人名
るみ	流海	固有人名
れおな	レオナ	固有人名
れみ	礼美	固有人名
